...................PPP
..PPPPPPPPPPPPPPPPPPPP
......................
P.....................
PPPPPPPPPPPPPPPPPP....
......................
....................PP
..PPPPPPPPPPPPPPPPPPPP
......................
......................
PPPPPPPPPPPPPPPPP.....
...................PPP
.................PPPPP
PPPPPPPPPPPPPPPPPPPPPP