......................
......................
...PPPPPPP..PPPPPPP...
......................
....................PP
...PPPPPPPPPPPPPPPPPPP
......................
......................
......................
PP..PPPPPPPPPPPPPPP..P
......................
......................
.....PPPPPPPPPPPPPPPPP
......................
..PP..................
PPPPPPPPPPPPPPPPPPPPPP