......................
......................
..PPPPPPPPPPP....PPPPP
......................
...............PP.....
PPPPPPPPP..PPPPPPPPPPP
......................
......................
PPPP...PPPPPPPPP..PPPP
......................
..PPPP................
......................
PPPPPPPPPP..PPPPPPPPP.
......................
......................
PPPPPPPPPPPPPPPPPPPPPP