......................
......................
PPPPPPPPPPPPPPPPP.....
......................
...................PP.
..................PPPP
PPPPPPPPPPPPPPPPPPPPPP
......................
......................
PPPPP..PPPPPP......PPP
......................
......................
PPPPPPPPPPPPPPPPPP....
......................
......................
PPPPPPPPPPPPPPPPPPPPPP