......................
......................
..PPPPPPPPPPPPPPPPPPPP
......................
PP....................
PPPP..................
PPPPPPPPPPPPPPPPPPP...
......................
....................PP
...PPPPPPPPPPPPPPPPPPP
......................
......................
PPPPPPPPPPPPPPPPP.....
...................PPP
.................PPPPP
PPPPPPPPPPPPPPPPPPPPPP