PPPPPPPPPP
P..F...W.P
P........P
P..A..X..P
P........P
P..L..B..P
P..E..Z..P
PPPPPPPPPP